网球王子
版本号：1.0.2
维护者：¿?CRazy
更新时间：2026-1-27
//人太多了而且其实新网王没看，有的角色我根本不认识，搜到几个算几个，罗马音参考ao3标签
词条
//立海大
Niou Masaharu=仁王雅治
Yagyuu Hiroshi=柳生比吕士
Yukimura Seiichi=幸村精市
Sanada Genichirou=真田弦一郎
Yanagi Renji=柳莲二
Kirihara Akaya=切原赤也
Marui Bunta=丸井文太
Jackal Kuwahara=胡狼桑原
//冰帝
Sakaki Tarou=榊太郎
Atobe Keigo=迹部景吾
Kabaji Munehiro=桦地崇弘
Oshitari Yuushi=忍足侑士
Mukahi Gakuto=向日岳人
Akutakawa Jirou=芥川慈郎
Ohtori Choutarou=凤长太郎
Shishido Ryoh=宍户亮
Hiyoshi wakashi=日吉若
Taki Haginosuke=泷荻之介
//四天宝寺
Shiraishi Kuranosuke=白石藏之介
Oshitari Kenya=忍足谦也
Chitose Senri=千岁千里
Tooyama Kintarou=远山金太郎
Zaizen Hikaru=财前光
Ishida Gin=石田银
Konjiki Koharu=金色小春
Hitouji Yuji=一氏裕次
Watanab Osamu=渡边修
Koishikawa  Kenjiro=小石川健二郎
//青学
Echizen Ryoma=越前龙马
Tezuka Kunimitsu=手冢国光
Fuji Suusuke=不二周助
Kikumaru Eiji=菊丸英二
Ooishi Shuuichirou=大石秀一郎
Inui Sadaharu=乾贞治
Kaidoh Kaoru=海堂薰
Momoshiro Takeshi=桃城武
Ryuzaki Sumire=龙崎堇
Ryuuzaki Sakuno=龙崎樱乃
Osakada Tomoka=小坂田朋香
Horio Satoshi=堀尾聪史
Katou Kachiro=加藤胜郎
Mizuno Katuo=水野胜雄
//比嘉中
Kite Eishirou=木手永四郎
Kai Yujiroh=甲斐裕次郎
Hirakoba Rin=平古场 凛
Chinen Hiroshi=知念宽
Tanishi Kei=田仁志 慧
Shiranui Tomoya=不知火知弥
Aragaki Koichi=新垣浩一
Saotome Harumi=早乙女晴海
//不动峰
Tachibana kippei=橘桔平
Tachibana An=橘杏
Kamio Akira=神尾明
Ibu Shinji=伊武深司
Ishida Tetsu=石田铁
Sakurai Masaya=樱井雅也
Uchimura Kyosuke=内村京介
Mori Tatsunori=森辰德
//六角中
Saeki Kojirou=佐伯虎次郎
Aoi Kentaroh=葵剑太郎
Harukaze Kurobane=黑羽春风
Kisaradu Ryou=木更津亮
Amane Hikaru=天根光
Itsuki Marehiko=树希彦
Shudo Satoshi=首藤聪
//圣鲁道夫
Mizuki Hajime=观月初
Fuji Yuuta=不二裕太
Kisarazu Atsushi=木更津淳
Yoshirou Akazawa=赤泽吉朗
Kaneda Ichiro=金田一郎
Nomura Takuya=野村拓也
//山吹
Sengoku Kiyosumi=千石清纯
Akutsu Jin=亚久津仁
Dan Taichi=坛太一
Minami Kentaro=南健太郎
Muromatsi Touji=室町十次
Nitobe Inakitsi=新渡米稻吉
Kita Kchiuma=喜多一马
Higashikata Masami=东方雅美
Banda Mikiya=伴田干也
//城成湘南
Kajimoto Takahisa=梶本贵久
Wakato Hiroshi=若人弘
Shinjō Reiji=神城玲治
Kiriyama Daichi=桐山大地
Ota Sho=太田翔
Tanaka Yohei= 田中洋平
Tanaka Kohei=田中浩平
Hanamura Aoi=华村葵
//名古屋星德
Liliadent Krauser=利利亚丹德·藏兔座
//U17
Byuodouin Houou=平等院凤凰
Tanegashima Syuji=种岛修二
Duke Watanabe=杜克·渡边
Tokugawa Kazuya=德川和也
Oni Jujiro=鬼十次郎
Omagari Ryuji=大曲龙次
Kimijima Ikuto=君岛育斗
Tohno Atsukyo=远野笃京
Kaji Kazena=加治凤多
Ochi Tsukimitsu=越知月光
Mouri  Jusaburou=毛利寿三郎
Irie Kanata=入江奏多
Echizen Ryoga=越前龙雅
Date Danji=伊达男儿
Hakamada Izo=袴田伊藏
Nakagauchi Sotomichi=中河内外道
Mistuya Akuto=三津谷亚玖斗
Yudai Yamato=大和佑大
//教练
Mifune Nyudo=三船入道
Kurobe Yukio=黑部由起夫
Saito Itaru=斋藤至
Tsuge Ryuji=拓植龙二
//德国
Michael·Bismarck=米海尔·俾斯麦
Schneider=施奈德
Jurgen·Borisovich·Volk=优尔根·巴里萨维奇·波尔克
Berti·Borisovich·Volk=贝尔蒂·巴里萨维奇·波尔克
//关智一希腊
Zeus·Iliopoulos=宙斯·伊利欧鲍罗斯
Hermes·Kounellis=赫尔墨斯·库奈里斯
Vulcan·Laertius=伏尔甘·拉尔修
Thalatta·Hercules=塔兰塔·赫拉克勒斯
Papadopoulos·Evangelos=帕帕多普洛斯·埃万盖洛斯
Apollo·Stephanopoulos=阿波罗·斯特凡诺普洛斯
Orion·Stephanopoulos=俄里翁·斯特凡诺普洛斯
//瑞士
Alexandria·Amadeus=亚历山大·阿玛迪斯
Peter·Lambiel=皮特·兰比尔
Albert·Federer=艾伯特·费德勒
//法国
Leopold·Camus·de·Charpentier=利奥波德·加缪·顿·夏庞蒂埃
Tristan·Bardot=特里斯坦·巴尔特
Edgar·Delacroix=埃德加·德拉克洛瓦
Timothee·Moreau=迪莫迪·莫洛
Jonathan·Saint·Georges=乔纳尔·桑·乔治
//西班牙
Antonio·Da·Médanore=安东奇奥·达·梅达诺雷
Mars·de·Colón=马尔斯·迪·考隆
Rodrigo·Roca·Rodrigo=罗德里格·罗卡·洛迪高
Romeo·Fernandez=罗密欧·费尔南德斯
Sedah：塞达
//美国
Ralph Rhinehart=拉尔夫·莱因哈特
Chic·Balentien=奇柯·巴连廷
//英国
Leon·Wakefield=雷欧·韦克菲尔德
//澳大利亚
Jason·Joseph·Dorgias=j·j·高尔吉亚
Jean·Fitzgerald=约翰·菲茨杰拉德
Chris·Hoppman=库里斯·侯普曼
Milky·Milman=米鲁克·米尔曼
Mac·Mcgregor=马克·麦克格雷戈
Noah·J·Dorgias=诺亚·高尔吉亚
//其他角色
Echizen Nanjirou=越前南次郎
Rinko Takeuchi=竹内伦子
Nanako Meino=美野菜菜子
Karupin=卡鲁宾
Fuji Yumiko=不二由美子
Shiba Saori=芝砂织
Inoue Mamoru=井上守
Kevin Smith=凯文·史密斯
禁翻词条
//以防万一还是加上了，明知Q·P的热度，哎，不说了
Q·P

